0 0 0 0 0 0 0 0 0 0 0 0 0 0 0 0
0 1 1 1 1 1 1 0 1 0 0 1 1 1 1 0
0 1 1 1 1 0 1 0 1 0 1 1 0 0 1 0
0 1 1 2 1 0 1 0 1 0 0 1 0 5 1 0
0 1 1 1 2 0 1 1 1 0 1 1 0 1 1 0
0 1 1 1 1 0 0 0 0 0 1 0 0 0 0 0
0 1 1 1 1 2 1 0 5 0 1 1 1 1 0 0
0 4 1 1 1 0 1 3 1 1 1 1 0 1 0 0
0 1 1 1 1 0 1 0 1 0 0 0 0 1 0 0
0 1 1 1 1 0 1 0 1 0 2 1 1 1 0 0
0 1 1 1 1 0 1 0 1 1 1 2 0 1 0 0
0 1 1 1 1 0 1 0 0 0 0 1 0 1 1 0
0 1 1 1 1 0 1 0 1 1 1 1 0 0 1 0
0 1 1 1 1 0 1 0 1 0 1 0 0 0 1 0
0 1 1 1 1 0 1 1 1 0 1 0 1 2 1 0
0 0 0 0 0 0 0 0 0 0 0 0 0 0 0 0